21,21
+-+-+-+-+-+-+-+-+-+-+
S     |         |   |
+-+-+ + +-+-+-+ + + +
|     | |       | | |
+ +-+-+ + +-+-+-+ + +
|   |   |     | | | |
+ +-+ +-+-+-+ + + + +
|     |     |     | |
+-+-+-+ +-+-+-+-+-+ +
|     |             |
+-+-+ +-+-+-+-+-+-+ +
|                   |
+ +-+-+-+-+-+-+-+-+-+
| |   |     |   |   |
+ + + + +-+ + + + + +
| | | | |   | |   | |
+ + + + + +-+ +-+-+ +
| | |   | |   | |   |
+ + +-+-+ +-+ + + + +
|       |     |   | F
+-+-+-+-+-+-+-+-+-+-+