+--+--+--+--+--+--+--+--+--+--+
#########|##############|#####|
+--+--+##+##+--+--+--+##+##+##+
|########|##|###########|##|##|
+##+--+--+##+##+--+--+--+##+##+
|##   |#####|########|  |##|##|
+##+--+##+--+--+--+##+  +##+##+
|########|        |########|##|
+--+--+--+  +--+--+--+--+--+##+
|        |                  ##|
+--+--+  +--+--+--+--+--+--+##+
|#############################|
+##+--+--+--+--+--+--+--+--+--+
|##|#####|########|#####|#####|
+##+##+##+##+--+##+##+##+##+##+
|##|##|##|##|#####|##|#####|##|
+##+##+##+##+##+--+##+--+--+##+
|##|##|#####|##|   ##|  |   ##|
+##+##+--+--+##+--+##+  +  +##+
|#####      |########|     |###
+--+--+--+--+--+--+--+--+--+--+