+--+--+--+--+--+--+--+--+--+--+--+--+--+--+--+--+--+--+--+--+--+--+--+--+--+--+--+--+--+--+--+--+--+--+--+--+--+--+--+--+--+--+--+--+--+--+--+--+--+--+
###|        |     |        |  |        |########|  |        |     |  |     |     |     |     |     |     |     |        |              |  |     |     |
+##+  +--+  +--+  +  +--+  +  +  +--+  +##+--+##+  +  +--+  +  +  +  +  +  +  +  +  +  +--+  +  +--+  +--+  +  +--+--+  +--+  +--+--+  +  +  +--+  +  +
|##|     |        |     |  |     |  |   ##   |#####|  |  |  |  |  |     |     |     |  |     |     |        |     |  |     |  |     |     |  |     |  |
+##+--+  +--+--+--+--+  +  +  +--+  +--+##+  +--+##+  +  +  +  +  +--+--+--+  +--+--+  +  +--+--+  +--+--+--+--+  +  +--+  +  +--+  +--+  +  +  +--+  +
|#####|  |     |        |     |     |   ##|  |#####|  |  |     |  |           |  |     |     |                 |        |  |     |        |     |  |  |
+--+##+  +  +  +--+--+--+  +--+  +--+  +##+--+##+--+  +  +--+  +  +--+--+--+  +  +  +--+--+  +--+--+--+--+--+  +--+  +  +  +--+  +--+--+--+  +--+  +  +
|  |##|     |  |########|     |  |     |##|#####|     |     |  |              |     |     |     |              |     |        |  |  |     |        |  |
+  +##+--+--+  +##+--+##+--+  +  +  +--+##+##+--+  +  +--+  +  +--+--+--+--+--+--+--+--+  +--+  +  +--+  +--+--+  +  +--+--+--+  +  +  +  +--+  +--+  +
|  |##|        |##|  |#####|     |  |#####|##   |  |     |  |  |#####|        |           |     |  |     |     |  |  |        |  |     |        |     |
+  +##+  +--+--+##+  +--+##+--+--+  +##+--+##+--+  +--+--+  +--+##+##+--+  +  +  +--+--+--+  +--+--+  +--+--+  +--+  +  +--+  +  +--+--+--+--+--+  +--+
|#####   |########|     |#####|     |#####|########|#####|     |##|##|     |     |     |     |        |           |  |  |     |     |     |     |     |
+##+--+--+##+--+--+  +  +--+##+--+--+--+##+--+--+##+##+##+--+  +##+##+  +--+  +--+  +  +  +--+  +--+--+  +--+--+  +  +--+  +--+--+  +  +  +--+  +--+  +
|###########|     |  |     |########|  |##|      #####|#####|  |##|##|  |     |     |           |        |  |     |  |     |        |  |        |  |  |
+--+--+--+--+  +--+  +--+  +--+--+##+  +##+  +--+--+--+--+##+  +##+##+  +  +--+  +--+--+--+--+--+  +--+--+  +  +--+  +  +--+  +--+--+  +--+--+--+  +  +
|     |        |     |  |        |##|  |##|  |     |      ##   |##|##|  |        |########|     |        |  |        |  |     |  |        |        |  |
+--+  +  +--+--+  +--+  +  +--+  +##+  +##+--+  +  +  +--+##+--+##+##+  +--+--+--+##+--+##+--+  +--+--+  +  +--+--+--+  +  +--+  +  +--+  +  +--+  +  +
|     |     |     |     |     |  |##|  |#####|  |     |#####|#####|##   |#####|#####|  |#####|  |        |     |        |  |     |  |     |  |  |     |
+  +--+--+  +--+  +  +--+--+  +  +##+  +--+##+  +--+--+##+--+##+--+##+--+##+##+##+--+  +--+##+  +  +--+--+  +--+  +--+--+  +  +--+  +  +--+  +  +--+--+
|  |              |     |     |   ##   |#####|        |#####|##|  |########|#####|  |     |##|  |  |     |              |  |  |     |  |     |  |     |
+  +--+--+--+--+  +  +  +--+--+--+##+--+##+--+--+--+  +--+##+##+  +--+--+--+--+--+  +--+  +##+  +  +  +  +--+--+  +--+  +  +  +  +--+  +  +--+  +  +  +
|              |  |  |  |###########   |##|     |     |  |#####|        |        |      #####|     |  |     |  |     |     |     |     |     |  |  |  |
+  +--+--+--+  +  +  +  +##+--+--+--+--+##+  +--+  +--+  +  +--+--+--+  +--+  +  +--+--+##+--+--+  +  +--+  +  +--+  +--+--+  +--+  +--+--+  +  +  +  +
|     |           |  |  |###########|#####|        |  |           |  |        |        |##|#####|  |     |     |     |     |  |  |  |        |  |  |  |
+--+  +  +--+--+--+--+  +--+--+  +##+##+--+--+--+--+  +--+--+  +  +  +  +--+--+--+--+  +##+##+##+  +--+  +--+--+  +--+  +  +  +  +  +  +--+--+  +  +  +
|     |              |  |  |     |##|#####|           |        |  |  |     |  |        |#####|##|  |              |     |  |  |  |  |  |     |  |  |  |
+  +--+--+--+--+  +  +  +  +  +--+##+--+##+  +--+--+--+--+  +--+  +  +--+  +  +  +--+--+--+--+##+  +  +  +--+--+--+  +--+--+  +  +  +  +  +--+  +  +  +
|  |     |     |  |     |     |#####|  |##|  |              |     |     |     |     |   ########|  |  |        |     |        |  |        |     |  |  |
+  +--+  +  +  +--+--+--+--+--+##+--+  +##+  +  +  +--+--+--+  +--+--+  +--+  +--+  +  +##+  +--+  +  +--+--+  +  +--+--+  +--+  +--+--+--+  +--+  +  +
|        |  |  |     |        |###########|     |           |  |     |  |        |     |##|  |     |     |     |  |  |     |  |     |  |     |     |  |
+--+--+--+  +--+  +  +--+--+  +--+  +--+--+--+--+--+--+--+  +  +  +  +  +--+--+--+--+--+##+  +  +--+--+  +  +--+  +  +  +--+  +--+  +  +  +--+  +--+  +
|        |        |        |        |           |     |     |     |     |###########|#####|  |        |  |     |     |  |     |        |  |     |  |  |
+  +--+  +--+--+--+--+--+  +  +--+--+  +--+--+  +  +--+  +--+--+--+--+--+##+--+--+##+##+--+  +--+  +  +  +--+  +--+  +  +  +--+  +  +--+  +  +--+  +  +
|     |                 |  |     |     |     |  |        |########|     |#####   |#####|  |     |  |  |  |  |        |        |  |     |  |     |  |  |
+  +--+--+--+--+--+--+  +  +--+  +  +--+  +  +  +  +  +--+##+--+##+--+  +--+##+  +--+--+  +  +  +  +  +  +  +--+  +--+--+  +  +  +--+  +  +--+  +  +  +
|     |     |        |           |  |     |     |  |     |#####|##############|        |  |  |     |     |     |  |        |     |     |     |     |  |
+--+  +  +  +  +  +--+--+  +--+  +  +--+--+  +--+  +--+--+--+##+--+--+--+--+--+--+--+  +  +  +--+--+--+--+  +--+  +  +--+  +--+--+  +--+--+  +--+--+  +
|  |  |  |     |           |     |     |  |  |     |###########|           |        |  |     |           |     |  |     |  |     |        |           |
+  +  +--+--+--+--+  +  +--+--+  +--+  +  +  +  +--+##+  +--+--+  +--+--+  +  +--+  +  +--+--+  +--+  +--+--+  +  +--+--+  +  +--+  +  +--+--+  +  +  +
|  |     |           |  |     |        |     |  |#####|  |     |     |     |     |  |  |     |  |  |     |  |     |     |  |        |     |     |  |  |
+  +--+  +  +--+--+--+--+  +  +--+--+--+--+--+--+##+--+  +--+  +--+  +  +--+--+--+  +  +--+  +  +  +--+  +  +--+--+  +  +  +--+--+--+--+  +  +--+--+  +
|        |  |     |        |              |#####|##|     |     |  |  |  |     |     |        |  |     |  |     |     |  |     |        |  |  |        |
+--+--+--+  +  +  +  +--+  +--+--+  +--+  +##+##+##+  +--+  +  +  +  +  +  +  +  +--+--+--+  +  +--+  +  +  +  +  +--+  +--+  +  +--+  +  +--+  +--+  +
|  |        |  |  |  |     |     |     |  |##|#####|        |     |  |  |  |  |     |     |  |  |     |     |  |     |        |  |     |        |     |
+  +  +--+--+  +--+  +  +  +  +  +--+  +--+##+--+--+--+--+--+--+--+  +  +  +  +--+  +  +  +--+  +  +--+  +--+  +--+  +--+--+--+  +  +--+--+  +  +  +--+
|     |  |     |     |  |  |  |  |        |##|########|  |        |  |     |     |  |  |  |     |  |     |     |  |  |        |  |           |  |     |
+  +--+  +  +--+  +--+  +  +  +  +--+--+  +##+##+  +##+  +  +--+  +  +  +--+--+  +  +  +  +  +--+  +  +--+  +--+  +  +  +--+  +  +--+--+--+--+--+--+  +
|     |  |        |     |  |  |        |  |#####|  |##|  |     |  |  |        |     |  |  |  |     |  |           |  |     |  |     |        |        |
+  +  +  +--+--+--+  +--+--+  +--+--+  +  +--+--+  +##+  +--+  +  +  +--+--+  +--+--+  +  +  +  +--+  +--+  +--+--+  +--+  +  +--+  +  +--+  +  +--+--+
|  |     |  |     |  |        |     |  |           |##|        |  |########|  |     |  |     |     |  |     |        |     |  |  |  |  |  |  |  |     |
+  +--+--+  +  +  +--+  +--+--+  +  +  +--+--+--+--+##+--+--+--+  +##+--+##+--+  +--+  +--+--+--+  +  +  +--+  +--+--+  +--+  +  +  +  +  +  +  +  +  +
|           |  |        |        |  |  |     |     |########|     |##|#####      |     |           |  |     |  |        |  |  |  |     |     |     |  |
+  +--+--+--+  +--+--+--+  +--+--+  +  +  +  +  +  +--+--+##+  +--+##+##+  +--+--+  +--+  +--+--+--+  +  +--+  +  +  +--+  +  +  +--+--+--+--+  +--+  +
|  |           |           |     |  |     |     |     |  |##|  |#####|##|     |  |  |     |     |  |  |     |  |  |  |     |  |     |        |  |     |
+  +  +--+--+--+  +--+--+--+--+  +  +  +--+--+--+--+  +  +##+  +##+--+##+--+  +  +  +  +--+  +  +  +  +--+  +  +--+  +  +  +  +  +  +  +--+  +  +  +--+
|  |  |        |        |        |     |              |  |##|  |#####|#####|     |     |     |  |  |     |  |  |        |  |     |  |     |     |  |  |
+  +  +  +--+  +--+--+  +--+  +--+--+--+  +--+--+--+--+  +##+  +--+##+--+##+--+  +--+--+  +--+  +  +  +--+  +  +  +--+--+--+--+--+  +--+  +--+--+  +  +
|  |  |     |        |     |        |  |        |###########|  |#####|  |##|     |     |     |  |        |     |     |     |     |     |  |     |     |
+  +  +--+  +--+  +  +--+  +--+--+  +  +--+--+  +##+--+  +--+  +##+--+  +##+  +--+  +--+  +  +  +--+--+  +--+--+--+  +  +  +--+  +--+--+  +  +  +--+--+
|  |     |     |  |  |  |  |        |  |        |##   |        |#####   |##|     |        |  |     |           |     |  |     |           |  |     |  |
+  +  +--+--+  +--+  +  +  +--+--+  +  +  +--+--+##+--+--+--+--+--+##+--+##+  +--+--+  +--+  +--+  +--+  +--+  +  +--+  +--+  +  +--+--+--+--+--+  +  +
|  |  |           |  |  |           |  |     |#####|########|########|#####|  |           |     |     |  |  |  |        |     |              |     |  |
+  +  +  +--+--+  +  +  +--+  +--+--+  +--+  +##+--+##+--+##+##+--+--+##+--+  +  +--+--+--+--+--+--+  +  +  +  +--+--+--+  +--+--+--+--+  +  +  +--+  +
|  |     |     |  |  |  |           |  |     |##|#####|#####|########|##|     |     |###########|     |  |     |     |     |        |     |     |     |
+  +--+--+  +--+  +  +  +  +--+--+  +  +  +--+##+##+--+##+--+  +--+##+##+  +--+--+--+##+--+--+##+  +--+  +--+--+--+  +  +--+--+--+  +  +--+--+--+  +  +
|     |     |     |  |  |        |  |     |  |#####|   #####|  |  |##|##|     |#####|##      |##|                    |  |           |  |           |  |
+--+  +  +--+  +--+  +  +--+--+  +  +--+--+  +--+--+  +--+##+  +  +##+##+--+--+##+##+##+--+--+##+  +--+--+--+--+--+--+  +  +--+--+--+  +--+--+--+--+  +
|     |  |  |  |        |     |  |  |  |     |        |#####|     |##|#####|#####|#####|#####|##|  |   #####|#####|     |  |        |                 |
+  +--+  +  +  +  +--+--+  +--+  +  +  +  +--+--+--+  +##+--+  +--+##+--+##+##+--+--+--+##+##+##+  +  +##+##+##+##+  +--+  +  +--+--+--+--+--+  +  +--+
|  |     |     |           |     |     |        |     |#####|     |##   |#####|        |##|#####|     |##|#####|##|        |        |           |     |
+  +  +  +  +--+--+--+--+  +  +--+--+--+--+--+  +  +--+--+##+--+--+##+--+--+  +--+--+  +##+--+--+--+--+##+--+--+##+  +  +--+--+--+  +--+  +--+--+--+  +
|  |  |  |  |        |     |  |                 |     |#####|########|        |        |#####   |#####|#####|#####|  |  |  |        |     |     |  |  |
+  +  +  +  +  +--+  +  +--+  +  +--+--+--+--+  +--+--+##+--+##+--+--+  +  +--+  +--+--+--+##+--+##+##+--+##+##+--+--+  +  +  +--+  +  +--+--+  +  +  +
|  |  |  |     |     |  |  |  |     |  |     |        |##|  |##|        |  |  |        |   ########|#####|##|##|        |        |  |           |     |
+  +--+  +--+  +  +--+  +  +  +--+  +  +  +--+--+--+  +##+  +##+--+  +--+  +  +--+--+  +--+--+--+--+--+##+##+##+  +--+--+--+--+--+  +--+--+--+--+--+--+
|     |        |  |  |  |     |  |  |        |     |  |#####|##|     |  |     |     |        |        |#####|##|     |           |     |           |  |
+--+  +--+--+--+  +  +  +--+--+  +  +  +--+  +  +  +  +  +##+##+  +--+  +--+--+  +  +--+--+  +--+--+  +--+--+##+--+  +  +--+  +  +--+  +  +--+--+  +  +
|              |  |     |     |  |     |     |  |  |     |#####|        |        |  |     |########|###########|     |     |  |     |     |     |     |
+--+--+--+--+  +  +  +--+  +  +  +--+--+  +--+  +  +--+--+--+--+--+--+--+  +--+--+  +  +  +##+--+##+##+--+--+  +  +--+--+  +  +--+  +  +--+  +--+--+  +
|     |     |     |     |  |  |           |     |  |     |     |     |     |     |  |  |  |#####|#####|        |  |        |     |  |  |     |        |
+  +--+  +  +  +--+--+  +--+  +  +--+--+--+  +--+  +  +  +  +  +--+  +  +--+  +  +  +--+  +--+##+--+--+--+--+--+  +--+--+--+--+  +  +  +  +--+  +--+--+
|  |     |     |     |     |  |              |     |  |     |     |        |  |  |  |     |#####|              |           |     |  |  |     |     |  |
+  +  +--+  +--+  +  +--+  +  +--+--+--+--+--+  +--+  +--+--+--+  +--+--+  +  +  +  +  +--+##+--+  +--+  +--+  +--+--+--+  +--+--+  +  +--+  +--+  +  +
|  |     |        |  |     |  |  |                 |     |     |           |  |        |#####|        |  |     |        |              |  |  |     |  |
+  +--+  +--+--+--+  +  +--+  +  +  +--+--+--+--+--+--+  +--+  +--+--+--+--+  +--+  +--+##+--+  +--+--+  +--+--+--+--+  +--+--+--+  +--+  +  +--+  +  +
|        |        |  |  |  |  |     |     |        |        |           |     |     |   ##   |  |           |        |  |        |  |     |  |     |  |
+--+--+--+  +--+  +  +  +  +  +--+--+  +  +  +  +  +--+--+  +--+--+--+  +  +--+  +--+  +##+  +--+  +--+--+  +  +--+  +  +  +  +--+  +  +--+  +  +--+  +
|     |     |        |              |  |     |  |           |        |        |  |     |##|        |     |     |     |     |        |  |              |
+  +--+  +--+--+--+--+--+  +  +--+  +  +--+--+  +--+--+--+--+  +--+  +--+--+--+  +  +--+##+--+--+--+  +  +--+--+--+  +--+  +--+--+--+  +--+--+--+  +--+
|  |        |              |  |     |     |     |     |        |  |              |  |  |#####|        |  |  |           |      #####   |     |     |  |
+  +  +--+--+  +--+--+--+--+  +  +--+--+  +--+--+  +  +  +--+--+  +--+--+--+--+--+  +  +--+##+  +--+--+  +  +  +--+--+  +--+--+##+##+--+  +  +--+--+  +
|     |        |        |     |     |     |        |  |           |     |        |  |########|  |     |     |  |     |  |########|#####|  |  |########|
+--+--+  +--+--+  +--+--+  +--+--+  +  +--+  +--+--+  +--+--+  +--+  +  +  +--+  +  +##+--+--+  +  +  +--+--+  +  +--+  +##+--+--+--+##+--+  +##+--+##+
|  |     |     |           |     |     |           |           |  |  |  |     |     |########|     |           |        |#####|########|#####|##|  |##|
+  +  +  +--+  +--+--+--+--+  +  +--+--+  +--+--+  +--+--+--+--+  +  +  +--+--+--+  +--+  +##+--+--+--+--+--+--+--+--+--+--+##+##+--+--+##+##+##+  +##+
|     |  |     |  |           |  |        |        |           |  |  |              |     |##############|###########|########|#####|#####|##|##|#####|
+--+--+  +  +--+  +  +  +  +--+  +  +--+--+  +--+--+  +--+--+  +  +  +--+--+--+--+--+  +--+--+--+--+--+##+##+  +--+##+##+--+--+--+##+##+--+##+##+##+--+
|  |     |  |  |     |  |     |  |     |  |           |     |  |     |     |     |     |  |           |##|##|     |##|##|###########|##|#####|##|#####|
+  +  +--+  +  +  +--+  +--+  +--+--+  +  +--+--+--+--+  +  +  +--+--+  +  +  +  +  +--+  +  +--+--+  +##+##+--+  +##+##+##+--+--+--+##+##+--+##+--+##+
|        |        |        |           |                 |     |        |     |     |              |   #####|     |#####|##############|########|   ###
+--+--+--+--+--+--+--+--+--+--+--+--+--+--+--+--+--+--+--+--+--+--+--+--+--+--+--+--+--+--+--+--+--+--+--+--+--+--+--+--+--+--+--+--+--+--+--+--+--+--+