+--+--+--+--+--+--+--+--+--+--+--+--+--+--+--+--+--+--+--+--+--+--+--+--+--+--+--+--+--+--+
######|     |   #####|########|#####|#####|########|                    |        |        |
+--+##+--+  +--+##+##+##+--+##+##+##+##+##+##+--+##+  +--+--+--+--+--+  +  +--+  +  +--+  +
|  |##|     |#####|##|##   |#####|#####|#####|#####|                 |  |  |  |     |     |
+  +##+  +--+##+--+##+##+--+--+--+--+--+--+--+##+--+--+--+--+--+--+  +  +  +  +--+--+  +--+
|  |##|  |#####   |#####      |  |###########|##|     |     |  |     |  |  |           |  |
+  +##+  +##+  +--+--+--+--+  +  +##+--+--+##+##+  +  +  +  +  +  +--+  +  +--+--+--+  +  +
|   ##   |##|     |           |   ########|#####|  |  |  |     |     |     |     |        |
+--+##+--+##+--+  +  +--+--+--+--+--+--+##+--+  +--+  +  +--+  +--+  +--+--+--+  +--+--+--+
|   ########|     |     |  |     |      #####|  |     |  |        |  |        |        |  |
+  +  +  +--+--+--+--+  +  +  +  +--+--+  +##+  +  +--+--+  +--+  +  +--+  +  +  +--+  +  +
|  |  |        |     |  |     |           |##|     |  |#####   |        |  |  |  |  |     |
+  +--+--+--+  +  +  +  +--+--+--+--+--+--+##+--+--+  +##+##+  +--+  +  +  +  +  +  +--+--+
|        |     |  |  |  |  |     |     |#####|#####|#####|##|  |     |     |        |     |
+--+--+  +  +--+  +--+  +  +  +--+  +  +##+--+##+##+##+--+##+  +--+--+--+--+--+--+--+  +  +
|  |     |     |        |  |     |  |#####|   ##|#####|  |##|              |           |  |
+  +  +--+--+  +--+--+--+  +--+  +  +##+--+--+##+--+--+  +##+--+--+  +--+  +  +--+--+--+  +
|  |  |        |     |        |     |#####|#####|###########|     |  |  |     |        |  |
+  +  +  +--+--+  +  +  +--+--+--+--+--+##+##+--+##+--+--+--+  +  +  +  +--+--+  +  +--+  +
|     |  |     |  |     |        |########|##|#####|     |     |     |           |        |
+--+--+  +  +  +  +  +--+  +--+  +##+--+--+##+##+--+  +  +--+--+--+--+--+--+--+--+--+--+--+
|           |     |           |  |###########|#####|  |        |  |        |              |
+  +--+  +--+--+--+--+--+--+  +  +--+--+--+--+--+##+  +--+--+  +  +  +--+  +  +--+--+--+  +
|  |  |           |        |  |           |########|        |  |     |  |     |        |  |
+  +  +--+--+--+  +  +--+  +  +--+--+--+--+##+--+--+--+--+--+  +--+--+  +--+--+  +--+--+  +
|  |              |     |  |        |#####|##|           |     |     |  |           |     |
+  +--+--+--+--+--+--+  +  +--+--+  +##+##+##+  +  +--+--+  +--+  +  +  +--+--+  +  +  +--+
|     |     |           |        |  |##|##|##|  |        |        |  |     |  |  |     |  |
+--+  +  +  +--+--+--+--+  +--+  +  +##+##+##+  +--+--+  +--+--+--+  +--+  +  +  +--+--+  +
|     |  |        |        |     |  |##|#####|  |#####|        |     |     |  |  |     |  |
+  +--+--+--+  +  +  +--+--+--+  +  +##+--+--+--+##+##+  +--+  +  +  +  +--+  +  +  +  +  +
|        |  |  |  |     |        |  |#####|#####|##|##|  |#####   |     |     |  |  |  |  |
+--+--+  +  +  +  +--+--+  +--+--+  +--+##+##+##+##+##+--+##+##+--+--+--+  +  +  +  +--+  +
|        |  |  |     |     |        |  |#####|##|##|########|##|     |     |  |     |     |
+  +--+--+  +  +  +--+  +--+  +--+--+  +--+--+##+##+--+--+--+##+  +  +  +--+--+  +--+  +--+
|     |        |     |  |  |  |     |  |  |   #####|  |########|  |     |              |  |
+--+  +  +--+--+--+  +  +  +  +  +  +  +  +  +--+--+  +##+--+--+--+  +  +  +  +  +--+--+  +
|     |        |     |     |     |  |  |  |  |     |  |##|           |  |  |  |  |     |  |
+  +--+  +--+  +  +--+  +--+--+--+  +  +  +  +--+  +  +##+  +--+--+--+--+  +  +  +  +  +  +
|  |     |     |     |        |     |  |  |        |#####|     |        |  |  |     |     |
+  +--+--+  +--+--+  +--+--+  +  +--+  +  +--+--+--+##+--+--+  +  +--+  +  +  +--+--+--+--+
|  |        |                 |  |     |  |        |##|#####|  |  |  |  |  |     |     |  |
+  +  +--+--+--+--+--+--+--+--+  +  +--+  +  +--+  +##+##+##+  +  +  +  +--+--+  +  +  +  +
|  |  |                       |     |     |     |  |##|##|##|  |  |  |           |  |     |
+  +  +  +--+--+--+--+--+--+  +--+--+  +--+--+  +--+##+##+##+  +  +  +--+--+--+--+  +--+--+
|     |  |                       |        |     |#####|##|##   |        |           |     |
+--+--+  +--+--+  +--+--+--+--+--+  +--+--+  +--+##+--+##+##+--+--+--+  +  +  +--+--+  +  +
|     |        |  |     |        |        |     |##|#####|##|           |  |           |  |
+  +  +--+--+  +  +  +  +  +--+  +--+--+  +  +--+##+##+--+##+  +--+--+  +  +--+--+--+--+  +
|  |  |  |     |     |  |     |        |         #####|  |##|        |  |     |     |     |
+  +  +  +  +--+--+--+  +--+--+--+--+  +--+--+--+  +--+  +##+--+--+--+  +--+  +  +  +  +--+
|  |     |     |     |  |        |     |     |  |     |  |########|########|  |  |     |  |
+  +--+  +--+  +  +  +  +  +--+  +  +--+  +  +  +--+  +  +--+--+##+##+--+##+  +--+--+--+  +
|  |     |     |  |     |  |  |     |     |  |        |   ########|##|#####|     |        |
+  +  +--+  +--+  +--+--+  +  +--+  +  +--+  +--+  +--+--+##+--+--+##+##+--+--+  +  +--+--+
|  |     |     |           |  |     |     |        |     |###########|##|     |  |     |  |
+  +--+  +--+  +--+--+--+--+  +  +--+--+  +--+--+--+  +  +--+--+--+--+##+--+  +  +--+  +  +
|  |     |           |     |  |        |  |  |        |  |     |########|                 |
+--+  +--+--+--+--+  +  +--+  +--+--+--+  +  +  +--+--+  +--+  +##+--+--+  +  +--+--+  +--+
|     |           |                          |  |     |     |  |##|     |  |     |  |     |
+  +--+  +  +--+  +--+--+--+--+--+  +--+  +  +  +--+  +--+  +  +##+  +  +--+--+  +  +--+  +
|  |  |  |  |  |        |     |     |     |  |        |     |  |##|  |  |        |        |
+  +  +  +  +  +--+--+  +  +  +--+--+  +--+  +--+--+--+--+  +  +##+  +  +  +--+--+--+--+--+
|  |     |  |     |  |     |  |        |  |     |  |        |   ##|  |     |     |        |
+  +--+--+  +--+  +  +--+--+  +  +--+--+  +--+  +  +  +--+--+--+##+  +--+--+--+  +--+--+  +
|     |        |           |     |     |        |  |     |########|     |     |  |        |
+--+  +  +--+--+--+  +  +--+--+--+--+  +--+  +--+  +--+  +##+--+--+--+  +--+  +  +  +--+--+
|        |     |  |  |              |  |     |           |##|        |     |  |  |        |
+--+--+--+  +  +  +  +--+--+--+--+  +  +  +--+  +  +  +--+##+  +--+--+--+  +  +  +--+--+  +
|           |     |     |     |  |  |     |     |  |     |##|        |     |  |     |     |
+  +--+--+  +--+--+--+  +  +  +  +  +--+--+  +  +  +--+--+##+--+--+  +  +--+  +--+  +  +  +
|  |     |  |              |     |        |  |  |        |##|     |  |     |     |  |  |  |
+--+  +  +  +  +  +--+--+--+  +--+--+--+  +  +  +--+--+  +##+  +  +  +--+  +--+  +  +  +  +
|     |  |  |  |     |     |  |        |     |     |  |   ##   |     |     |     |  |  |  |
+  +--+  +  +  +--+--+  +  +  +  +--+  +--+--+--+  +  +--+##+--+--+--+  +--+  +--+  +  +--+
|  |  |  |        |     |     |  |     |           |  |   ##|     |     |     |     |     |
+  +  +  +--+--+--+  +--+--+  +  +--+--+--+--+--+--+  +--+##+  +  +  +--+  +--+  +--+--+  +
|  |  |        |     |     |  |  |     |           |########|  |  |     |     |           |
+  +  +--+--+  +  +--+  +  +  +  +  +  +  +--+--+  +##+--+--+  +  +--+  +--+  +  +--+--+--+
|     |  |     |  |  |  |  |  |     |     |        |#####   |  |  |###########|   #####|  |
+--+--+  +  +--+  +  +  +  +--+--+  +--+--+  +--+--+  +##+  +--+  +##+  +  +##+--+##+##+  +
|     |  |        |     |           |        |     |  |##|     |#####|  |  |##|#####|##|  |
+--+  +  +--+--+--+--+  +  +--+--+--+  +--+--+--+  +--+##+--+  +##+--+  +  +##+##+--+##+  +
|     |           |     |  |        |  |        |  |#####|  |  |##|     |  |##|##|#####|  |
+  +--+--+  +--+  +--+--+--+  +--+  +  +  +--+  +  +##+  +  +  +##+  +--+  +##+##+##+--+  +
|  |  |     |  |        |     |     |  |     |     |##|  |     |##|     |  |#####|##   |  |
+  +  +  +--+  +--+  +--+  +--+  +--+  +--+  +--+  +##+--+--+--+##+--+  +  +--+--+##+--+  +
|     |     |     |     |     |        |        |  |##############|     |     |  |##|#####|
+  +  +--+  +--+  +--+  +  +  +--+  +--+--+--+  +  +--+--+--+--+--+  +--+--+  +  +##+##+##+
|  |     |     |  |     |  |     |  |           |     |  |           |     |     |#####|##|
+  +--+  +--+  +  +  +--+--+--+--+  +--+--+--+--+--+  +  +  +--+--+--+  +  +--+--+  +--+##+
|     |     |     |     |        |           |        |     |  |     |  |           |#####|
+--+--+--+  +--+--+--+  +  +--+  +--+--+--+  +--+  +--+  +--+  +  +  +  +--+  +--+--+##+--+
|     |  |        |        |  |           |              |        |  |     |  |########|  |
+  +  +  +--+--+  +--+--+--+  +--+--+--+  +--+--+--+--+--+  +--+--+  +--+  +  +##+--+--+  +
|  |        |  |           |           |     |     |     |     |     |     |  |#####|#####|
+  +--+--+  +  +--+--+  +  +  +--+--+  +--+  +  +  +  +--+--+  +  +--+  +--+--+--+##+##+##+
|  |     |        |     |        |     |     |  |        |     |  |     |  |     |#####|##|
+  +  +  +--+--+  +--+--+--+  +  +--+--+  +  +  +--+  +  +  +  +  +  +--+  +  +  +--+--+##+
|     |        |              |           |     |     |     |  |     |        |         ###
+--+--+--+--+--+--+--+--+--+--+--+--+--+--+--+--+--+--+--+--+--+--+--+--+--+--+--+--+--+--+